XXXXXXXXXXXXXXXXXXXX
X        X   X     X
XX XXX XXX X XXXXX X
X   X      X       X
XX  XXXXX XXXX XXXXX
X       X    X     X
X XXXX XX XX  X XXXX
XSX     XX XX      X 
X X XXX X  X  X XXXX
X X   X   XX XX  X X 
X XX XXXXXX   XX X X
X    X   X  X X    X
X XXXX X X X  XXXX X
X      X   XX    G X
XXXXXXXXXXXXXXXXXXXX