XXXXXXXXXXXXXXXXXXXX
XS       Xx        X
X        xx        X
X        xX        X
X        XX        X
X        XX        X
X        XX        X
X        XX        X 
X        XX        X
X        XX        X
X        XX        X
X        XX        X
X        XX        X
X        XX       GX
XXXXXXXXXXXXXXXXXXXX